#.......@
#.#######
#.#.....#
#.#.###.#
#.#.#.#.#
#.#.#.#.#
#.#...#.#
#.#####.#
#.......#
#########