@#...#...#.
.#.#.#.#.#.
.#.#.#.#.#.
.#.#.#.#.#.
.#.#.#.#.#.
.#.#.#.#.#.
.#.#.#.#.#.
.#.#.#.#.#.
.#.#.#.#.#.
...#...#...